0,0,0,0,0,0,0,0,0,0,0,0,0,0,0,0,0,0,0,0,0,0,0,0,0,0,0,0,0,0,0,0,0,0,0,0,0,0,0,0
0,0,0,0,0,0,0,0,0,0,0,0,0,0,0,0,0,0,0,0,0,0,0,0,0,0,0,0,0,0,0,0,0,0,0,0,0,0,0,0
0,0,0,0,0,0,0,0,0,0,0,0,0,0,0,0,0,0,0,0,0,0,0,0,0,0,0,0,0,0,0,0,0,0,0,0,0,0,0,0
0,0,0,0,0,0,0,0,0,0,0,0,0,0,0,0,0,0,0,0,0,0,0,0,0,0,0,0,0,0,0,0,0,0,0,0,0,0,0,0
0,0,0,0,0,0,0,0,0,0,0,0,0,0,0,0,0,0,0,0,0,0,0,0,0,0,0,0,0,0,0,0,0,0,0,0,0,0,0,0
0,0,0,0,0,0,3,11,9,0,0,0,3,9,0,0,0,0,3,11,11,9,0,0,0,0,3,9,0,0,0,3,11,9,0,0,0,0,0,0
0,0,0,0,0,0,0,0,0,0,0,0,0,0,0,0,0,0,0,0,0,0,0,0,0,0,0,0,0,0,0,0,0,0,0,0,0,0,0,0
0,0,0,0,0,0,0,0,0,0,0,0,0,0,0,0,0,0,0,0,0,0,0,0,0,0,0,0,0,0,0,0,0,0,0,0,0,0,0,0
15,11,11,11,11,11,11,9,0,0,0,0,0,0,0,3,9,0,0,0,0,0,0,3,9,0,0,0,0,0,0,0,3,11,11,11,11,11,11,15
14,0,0,0,0,0,0,0,0,0,0,0,0,0,0,0,0,0,0,0,0,0,0,0,0,0,0,0,0,0,0,0,0,0,0,0,0,0,0,8
14,0,0,0,0,0,0,0,0,0,0,0,0,0,0,0,0,0,0,0,0,0,0,0,0,0,0,0,0,0,0,0,0,0,0,0,0,0,0,8
14,0,0,0,0,0,0,0,0,0,3,11,11,11,11,11,9,0,0,0,0,0,0,3,11,11,11,11,11,9,0,0,0,0,0,0,0,0,0,8
14,0,0,0,0,0,0,0,0,0,0,0,0,0,0,0,0,0,0,0,0,0,0,0,0,0,0,0,0,0,0,0,0,0,0,0,0,0,0,8
14,0,0,0,0,0,0,0,0,0,0,0,0,0,0,0,0,0,0,0,0,0,0,0,0,0,0,0,0,0,0,0,0,0,0,0,0,0,0,8
14,0,0,0,0,0,0,0,0,0,0,0,0,0,0,0,0,0,0,0,0,0,0,0,0,0,0,0,0,0,0,0,0,0,0,0,0,0,0,8
10,0,0,0,0,0,0,0,0,0,0,0,0,0,0,0,0,7,11,11,11,11,13,0,0,0,0,0,0,0,0,0,0,0,0,0,0,0,0,4
0,0,0,0,0,0,0,0,0,0,0,0,0,0,0,0,0,6,0,0,0,0,6,0,0,0,0,0,0,0,0,0,0,0,0,0,0,0,0,0
0,0,0,0,0,0,0,0,0,0,0,0,0,0,0,0,0,6,0,0,0,0,6,0,0,0,0,0,0,0,0,0,0,0,0,0,0,0,0,0
0,0,7,15,15,15,15,15,15,15,15,15,13,0,0,0,0,6,0,0,0,0,6,0,0,0,0,7,15,15,15,15,15,15,15,15,15,13,0,0
0,0,8,12,12,12,12,12,12,12,12,12,10,0,0,0,0,6,0,0,0,0,6,0,0,0,0,4,12,12,12,12,12,12,12,12,12,14,0,0
0,0,6,0,0,0,0,0,0,0,0,0,0,0,0,0,0,6,0,0,0,0,6,0,0,0,0,0,0,0,0,0,0,0,0,0,0,6,0,0
0,0,6,0,0,0,0,0,0,0,0,0,0,0,0,0,3,12,15,15,15,15,12,9,0,0,0,0,0,0,0,0,0,0,0,0,0,6,0,0
0,0,6,0,0,0,0,0,0,0,0,0,0,0,0,0,0,0,4,16,16,10,0,0,0,0,0,0,0,0,0,0,0,0,0,0,0,6,0,0
0,0,6,0,0,0,0,0,0,0,0,0,0,0,0,0,0,0,0,4,10,0,0,0,0,0,0,0,0,0,0,0,0,0,0,0,0,6,0,0
0,0,6,0,0,0,0,0,0,0,0,3,11,11,11,9,0,0,0,8,14,0,0,0,3,11,11,11,9,0,0,0,0,0,0,0,0,6,0,0
0,0,6,0,0,0,0,0,0,0,0,0,0,6,0,0,0,0,0,8,14,0,0,0,0,0,6,0,0,0,0,0,0,0,0,0,0,6,0,0
0,0,6,0,0,0,0,0,0,5,0,0,0,6,0,0,0,0,0,8,14,0,0,0,0,0,6,0,0,0,5,0,0,0,0,0,0,6,0,0
0,0,8,11,11,11,11,11,11,14,0,0,0,6,0,0,0,0,0,8,14,0,0,0,0,0,6,0,0,0,8,11,11,11,11,11,11,14,0,0
0,0,2,0,8,14,8,14,0,2,0,0,0,6,0,0,0,0,0,8,14,0,0,0,0,0,6,0,0,0,2,0,8,14,8,14,0,2,0,0
0,0,0,0,8,14,8,14,0,0,0,0,0,6,0,0,0,0,0,8,14,0,0,0,0,0,6,0,0,0,0,0,8,14,8,14,0,0,0,0
